##########
######S###
##  ## ###
###M     #
#   ### ##
# # ###  #
# # ###  #
#   #  A##
# #D##  ##
##########