##########
# ##### S#
#   ### ##
##   ## ##
####   A #
##### ## #
##D##M   #
## ####  #
##      ##
##########
