##########
# ##### S#
# A#### ##
##  M## ##
## #   A #
## ### ###
## ###  ##
## #### ##
##D#    ##
##########
