##########
# ##### S#
#   ### ##
##   ## ##
####   M #
##### ## #
##D##    #
## ####  #
##     M##
##########
