##########
#D  ######
##     ###
#  ### ###
# #### A #
# #### # #
#M####   #
### ### ##
S    A  ##
##########