##########
#D  ###  #
###  ## ##
#### ## ##
####     #
######## #
##S##### #
## ####  #
##      ##
##########
