##########
# ##### S#
#   ### ##
### M## ##
####   A #
##### ####
##D##   ##
## #### ##
##      ##
##########
